32
16
00000000000000000000000000000000
00                            00
00                            00
00                            00
00                            00
11                            11
11                            11
11                            11
11                            11
11                            11
11                            11
11                            11
11                            11
11      e   1     e   1   e   11
11111111111111111111111111111111
11111111111111111111111111111111