30
15
000000000000000000000000000000
0                            0
0                            0
0                            0
0                            0
1                            1
1                          1 1
1               1      1     1
1      1111                  1
1 11                         1
1          1    1            1
1                     1      1
1      11           1        1
1              11            1
111111111111111111111111111111